20 12
20 20 20 20 20 20 20 20 20 20 20 20 20 20 20 20 20 20 20 20
20 20 20 20 20 20 20 20 20 20 20 20 20 20 20 20 20 20 20 20
20 20 20 20 20 20 20 20 20 20 20 20 20 20 20 20 20 20 20 20
20 20 20 20 20 20 20 20 20 20 20 20 20 20 20 20 20 20 20 20
20 20 20 20 20 20 20 20 20 20 20 20 20 20 20 20 20 20 20 20
20 20 20 20 20 20 20 20 20 20 20 20 20 20 20 20 20 20 20 20
20 20 20 20 20 20 20 20 20 20 20 20 20 20 20 20 20 20 20 20
20 20 20 20 20 20 20 20 20 20 20 20 20 20 20 20 20 20 20 20
18 17 18 17 18 17 18 17 18 17 18 17 18 17 18 17 18 17 18 17
17 18 17 18 17 18 17 18 17 18 17 18 17 18 17 18 17 18 17 18
18 17 18 17 18 17 18 17 18 17 18 17 18 17 18 17 18 17 18 17
17 18 17 18 17 18 17 18 17 18 17 18 17 18 17 18 17 18 17 18