51 30
0 0 0 0 0 0 0 0 0 0 0 0 0 0 0 0 0 0 0 0 0 0 0 0 0 0 0 0 0 0 0 0 0 0 0 0 0 0 0 0 0 0 0 0 0 0 0 0 0 0 0
0 0 0 0 0 0 0 0 0 0 0 0 0 0 0 0 0 0 0 0 0 0 0 0 0 0 0 0 0 0 0 0 0 0 0 0 0 0 0 0 0 0 0 0 0 0 0 0 0 0 0
0 0 0 0 0 0 0 0 0 0 0 0 0 0 0 0 0 0 0 0 0 0 0 0 0 0 0 0 0 0 0 0 0 0 0 0 0 0 0 0 0 0 0 0 0 0 0 0 0 0 0
0 0 0 0 0 0 0 0 0 0 0 0 0 0 0 0 0 0 0 0 0 0 0 0 0 9 0 0 0 0 0 0 0 0 0 0 0 0 0 0 0 0 0 0 0 0 0 0 0 0 0
0 0 0 0 0 0 0 0 0 0 0 0 0 0 0 0 0 0 0 0 0 0 0 0 2 3 4 0 0 0 0 0 0 0 0 0 0 0 0 0 0 0 0 0 0 0 0 0 0 0 0
0 0 0 0 0 0 0 0 0 0 0 0 0 0 0 0 0 0 0 0 0 0 0 6 16 16 16 10 0 0 0 0 0 0 0 0 0 0 0 0 0 0 0 0 0 0 0 0 0 0 0
0 0 0 0 0 0 0 0 0 0 0 0 0 0 0 0 0 0 0 0 0 0 6 16 16 7 5 16 10 0 0 0 0 0 0 0 0 0 0 0 0 0 0 0 0 0 0 0 0 0 0
0 0 0 0 0 0 0 0 0 0 0 0 0 0 0 0 0 0 0 0 0 6 16 8 8 5 5 16 16 10 0 0 0 0 0 0 0 0 0 0 0 0 0 0 0 0 0 0 0 0 0
0 0 0 0 0 0 0 0 0 0 0 0 0 0 0 0 0 0 0 0 6 16 7 5 5 5 5 5 5 16 10 0 0 0 0 0 0 0 0 0 0 0 0 0 0 0 0 0 0 0 0
0 0 0 0 0 0 0 0 0 0 0 0 0 0 0 0 0 0 0 6 8 5 5 5 5 5 5 8 5 16 16 10 0 0 0 0 0 0 0 0 0 0 0 0 0 0 0 0 0 0 0
0 0 0 0 0 0 0 0 0 0 0 0 0 0 0 0 0 0 6 7 5 5 5 5 5 5 5 5 5 5 5 16 10 0 0 0 0 0 0 0 0 0 0 0 0 0 0 0 0 0 0
0 0 0 0 0 0 0 0 0 0 0 0 0 0 0 0 0 6 7 5 5 5 5 5 5 5 5 5 5 5 8 16 16 10 0 0 0 0 0 0 0 0 0 0 0 0 0 0 0 0 0
0 0 0 0 0 0 0 0 0 0 0 0 0 0 0 0 6 7 5 5 5 5 8 8 8 5 5 5 5 5 5 16 16 16 10 0 0 0 0 0 0 0 0 0 0 0 0 0 0 0 0
0 0 0 0 0 0 0 0 0 0 0 0 0 0 0 6 7 5 5 5 5 5 5 5 5 5 5 5 5 5 5 16 16 16 16 10 0 0 0 0 0 0 0 0 0 0 0 0 0 0 0
0 0 0 0 0 0 0 0 0 0 0 0 0 0 1 8 8 5 5 5 5 5 5 5 5 5 5 5 5 5 5 8 8 8 16 16 10 0 0 0 0 0 0 0 0 0 0 0 0 0 0
0 0 0 0 0 0 0 0 0 0 0 0 0 6 16 16 16 5 5 5 5 5 5 5 5 5 5 5 5 5 5 5 5 16 16 16 16 10 0 0 0 0 0 0 0 0 0 0 0 0 0
0 0 0 0 0 0 0 0 0 0 0 0 6 16 16 7 5 5 5 5 5 5 5 5 5 5 5 5 5 5 5 5 5 5 5 16 16 16 10 0 0 0 0 0 0 0 0 0 0 0 0
0 0 0 0 0 0 0 0 0 0 0 6 16 16 7 8 5 5 5 8 8 5 5 5 5 8 8 8 8 5 5 5 5 5 5 5 5 16 16 10 0 0 0 0 0 0 0 0 0 0 0
0 0 0 0 0 0 0 0 0 0 6 16 16 16 7 5 5 5 5 5 5 5 5 5 5 5 5 5 5 5 5 5 5 5 5 5 5 5 5 16 10 0 0 0 0 0 0 0 0 0 0
0 0 0 0 0 0 0 0 0 6 7 8 8 8 8 5 5 5 5 5 5 5 5 5 5 5 5 5 5 5 5 5 5 5 5 5 8 8 5 5 16 10 0 0 0 0 0 0 0 0 0
0 0 0 0 0 0 0 0 6 16 5 5 5 5 5 5 5 5 5 5 5 5 5 5 5 5 5 5 8 5 5 5 5 5 5 5 5 5 5 5 5 16 10 0 0 0 0 0 0 0 0
0 0 0 0 0 0 0 6 16 16 5 5 5 5 5 5 5 5 5 8 8 8 8 8 5 5 5 5 5 5 5 5 5 5 5 5 5 5 5 5 5 5 5 10 0 0 0 0 0 0 0
0 0 0 0 0 0 6 16 16 7 5 5 5 5 5 5 5 5 5 5 5 5 5 5 5 5 5 5 5 5 5 5 5 5 5 5 5 5 5 5 5 5 5 16 10 0 0 0 0 0 0
0 0 0 0 0 6 16 16 5 5 5 8 8 8 5 5 5 5 5 5 5 5 5 5 5 5 5 5 5 5 8 8 8 5 5 5 5 5 5 5 5 5 5 5 5 10 0 0 0 0 0
0 0 0 0 6 16 16 7 5 5 5 5 5 5 5 5 8 5 5 5 5 8 5 5 5 5 5 5 5 5 5 5 5 5 5 5 5 5 8 8 5 8 5 5 5 16 10 0 0 0 0
0 0 0 1 16 16 7 5 5 5 5 5 5 5 5 5 5 5 5 5 5 5 5 5 5 5 5 5 5 5 5 5 5 5 5 5 5 5 5 5 5 5 5 5 5 16 16 10 -1 -1 -1
0 0 6 16 7 5 5 5 5 8 5 5 5 5 5 5 5 5 5 5 5 5 5 8 8 8 5 5 5 5 5 5 5 5 5 5 5 5 5 5 5 5 5 5 5 5 5 16 10 -1 -1
0 1 16 7 5 5 8 5 5 5 5 5 5 8 8 8 8 5 5 5 5 5 5 5 5 5 5 5 5 5 5 5 8 8 5 5 5 5 5 5 5 5 5 5 5 5 5 16 16 10 -1
6 16 7 5 5 5 5 8 5 5 5 5 5 5 5 5 5 5 5 5 5 5 5 5 5 5 5 5 5 5 5 5 5 5 5 5 5 5 5 5 5 5 5 5 5 5 5 5 5 5 10
12 12 12 13 12 12 13 13 13 13 13 12 12 12 13 13 12 12 12 13 13 13 13 13 13 13 13 12 12 12 12 12 13 13 13 13 13 13 13 13 13 12 12 12 13 13 13 13 13 12 13