30 18
2 2 2 2 2 2 2 2 2 2 2 2 2 2 2 2 2 2 2 2 2 2 2 2 2 2 2 2 2 2
2 2 2 2 2 2 2 2 2 2 2 2 2 2 2 2 2 2 2 2 2 2 2 2 2 2 2 2 2 2
2 2 2 2 2 2 2 2 2 2 2 2 2 2 2 2 6 7 2 2 2 2 2 2 2 2 2 2 2 2
2 2 2 2 2 2 2 2 2 2 2 2 2 2 2 6 5 8 7 2 2 2 2 2 2 2 2 2 2 2
2 2 2 2 2 2 2 2 2 2 2 2 2 2 6 5 5 8 8 7 2 2 2 2 2 2 2 2 2 2
2 2 2 2 2 2 2 2 2 2 2 2 2 6 5 5 5 8 9 8 7 2 2 2 2 2 2 2 2 2
2 2 2 2 2 2 2 2 2 2 2 2 6 5 5 5 5 8 9 9 8 7 2 2 2 2 2 2 2 2
2 2 2 2 2 2 2 2 2 2 2 6 5 5 5 5 9 8 8 8 8 8 7 2 2 2 2 2 2 2
2 2 2 2 2 6 7 2 2 2 6 5 9 9 5 5 9 8 8 8 9 8 8 7 2 2 2 2 2 2
2 2 2 2 6 5 8 4 2 6 5 5 5 5 5 5 9 9 8 8 9 9 8 8 7 2 2 2 2 2
2 2 2 6 5 5 9 3 4 5 5 5 9 5 5 9 9 9 8 8 8 8 8 8 8 7 2 2 2 2
2 2 6 5 5 9 8 3 3 5 5 9 9 5 5 5 5 8 8 8 8 8 8 8 9 8 7 2 2 2
1 1 1 1 1 1 1 1 1 1 1 1 1 1 1 1 1 1 1 1 1 1 1 1 1 1 1 1 1 1
0 0 0 0 0 0 0 0 0 0 0 0 0 0 0 0 0 0 0 0 0 0 0 0 0 0 0 0 0 0
0 0 0 0 0 0 0 0 0 0 0 0 0 0 0 0 0 0 0 0 0 0 0 0 0 0 0 0 0 0
0 0 0 0 0 0 0 0 0 0 0 0 0 0 0 0 0 0 0 0 0 0 0 0 0 0 0 0 0 0
0 0 0 0 0 0 0 0 0 0 0 0 0 0 0 0 0 0 0 0 0 0 0 0 0 0 0 0 0 0
0 0 0 0 0 0 0 0 0 0 0 0 0 0 0 0 0 0 0 0 0 0 0 0 0 0 0 0 0 0