75 16
2 2 2 2 2 2 2 2 2 2 2 2 2 2 2 2 2 2 2 2 2 2 2 2 2 2 2 2 2 2 2 2 2 2 2 2 2 2 2 2 2 2 2 2 2 2 2 2 2 2 2 2 2 2 2 2 2 2 2 2 2 2 2 2 2 2 2 2 2 2 2 2 2 2 2
2 2 2 2 2 2 2 2 2 2 2 2 2 2 2 2 2 2 2 2 2 2 2 2 2 2 2 2 2 2 2 2 2 2 2 2 2 2 2 2 2 2 2 2 2 2 2 2 2 2 2 2 2 2 2 2 2 2 2 2 2 2 2 2 2 2 2 2 2 2 2 2 2 2 2
2 2 2 2 2 2 2 2 2 2 2 2 2 2 2 2 2 2 2 2 2 2 2 2 2 2 2 2 2 2 2 2 2 2 2 2 2 2 2 2 2 2 2 2 2 2 2 2 2 2 2 2 2 2 2 2 2 2 2 2 2 2 2 2 2 2 2 2 2 2 2 2 2 2 2
2 2 2 2 2 2 2 2 2 2 2 2 2 2 2 2 2 2 2 2 2 2 2 2 2 2 2 2 2 2 2 2 2 2 2 2 2 2 2 2 2 2 2 2 2 2 2 2 2 2 2 2 2 2 2 2 2 2 2 2 2 2 2 2 2 2 2 2 2 2 2 2 2 2 2
3 3 3 3 3 3 3 3 3 3 3 3 3 3 3 3 3 3 3 3 3 3 3 3 3 3 3 3 3 3 3 3 3 3 3 3 3 3 3 3 3 3 3 3 3 3 3 3 3 3 3 3 3 3 3 3 3 3 3 3 3 3 3 3 3 3 3 3 3 3 3 3 3 3 3
4 4 4 4 4 4 4 4 4 4 4 4 4 4 4 4 4 4 4 4 4 4 4 4 4 4 4 4 4 4 4 4 4 4 4 4 4 4 4 4 4 4 4 4 4 4 4 4 4 4 4 4 4 4 4 4 4 4 4 4 4 4 4 4 4 4 4 4 4 4 4 4 4 4 4
4 4 4 4 4 4 4 4 4 4 4 4 4 4 4 4 4 4 4 4 4 4 4 4 4 4 4 4 4 4 4 4 4 4 4 4 4 4 4 4 4 4 4 4 4 4 4 4 4 4 4 4 4 4 4 4 4 4 4 4 4 4 4 4 4 4 4 4 4 4 4 4 4 4 4
5 5 5 5 5 5 5 5 5 5 5 5 5 5 5 5 5 5 5 5 5 5 5 5 5 5 5 5 5 5 5 5 5 5 5 5 5 5 5 5 5 5 5 5 5 5 5 5 5 5 5 5 5 5 5 5 5 5 5 5 5 5 5 5 5 5 5 5 5 5 5 5 5 5 5
6 6 6 6 6 6 6 6 6 6 6 6 6 6 6 6 6 6 6 6 6 6 6 6 6 6 6 6 6 6 6 6 6 6 6 10 6 6 6 6 6 6 6 6 6 6 6 6 6 6 6 6 6 7 8 8 8 8 8 8 8 8 8 9 6 6 6 6 6 6 6 6 6 6 6
6 6 6 6 6 6 6 6 6 6 6 6 10 6 6 10 6 6 6 6 6 6 6 6 6 6 6 6 6 6 6 6 6 7 8 8 8 8 8 8 9 6 6 6 6 6 6 6 6 6 6 6 6 11 11 11 11 0 11 11 11 11 11 11 9 6 6 6 6 6 6 6 6 6 6
6 6 6 6 6 6 6 6 6 6 6 7 8 8 8 8 8 9 6 6 6 6 6 6 6 6 6 6 6 6 6 6 7 11 11 11 11 11 11 11 11 9 6 6 6 6 6 6 6 6 6 6 7 11 11 11 0 0 0 11 11 11 11 11 11 9 10 6 6 6 6 6 6 6 6
6 6 6 6 6 6 6 6 6 10 6 11 11 11 11 11 11 11 9 6 6 6 6 6 6 6 6 6 6 6 6 7 11 11 11 11 11 11 11 11 11 11 9 10 6 6 6 6 6 6 6 6 11 11 11 0 0 0 0 11 11 11 11 11 11 11 9 10 6 6 6 6 6 6 6
6 6 6 6 6 6 10 6 7 8 8 11 11 11 11 11 11 11 11 6 6 6 6 6 6 6 6 6 6 6 7 11 11 11 0 0 0 11 11 11 11 0 0 0 0 6 6 6 6 6 6 6 11 0 0 0 0 0 0 0 0 11 11 11 11 11 11 11 11 9 6 6 6 6 6
6 6 6 6 6 7 8 9 11 11 11 11 11 11 11 11 11 11 11 9 6 10 6 6 6 6 6 10 6 7 11 11 0 0 0 0 0 0 11 11 11 0 0 0 0 0 0 0 0 10 6 7 0 0 0 0 0 0 0 0 0 0 0 11 11 11 11 11 11 11 9 6 10 6 6
0 0 0 0 0 0 0 0 0 0 0 0 0 0 0 0 0 0 0 0 0 0 0 0 0 0 0 0 0 0 0 0 0 0 0 0 0 0 0 0 0 0 0 0 0 0 0 0 0 0 0 0 0 0 0 0 0 0 0 0 0 0 0 0 0 0 0 0 0 0 0 0 0 0 0
1 1 1 1 1 1 1 1 1 1 1 1 1 1 1 1 1 1 1 1 1 1 1 1 1 1 1 1 1 1 1 1 1 1 1 1 1 1 1 1 1 1 1 1 1 1 1 1 1 1 1 1 1 1 1 1 1 1 1 1 1 1 1 1 1 1 1 1 1 1 1 1 1 1 1