27 30
1 1 1 1 1 1 1 1 1 1 1 3 1 1 1 1 1 1 1 1 1 1 1 1 1 1 1
1 1 1 1 1 1 1 1 1 1 1 1 1 1 1 1 1 1 1 1 1 1 1 1 1 1 1
1 1 1 1 1 1 1 1 1 1 1 1 1 1 1 1 1 1 1 1 1 1 1 1 1 1 1
1 1 1 1 1 1 1 1 1 1 1 1 1 1 1 1 1 1 1 1 1 1 1 1 1 1 1
1 1 1 1 1 1 1 1 1 1 1 1 1 1 1 1 1 1 1 1 1 1 1 1 1 1 1
1 1 1 1 1 1 1 1 1 1 1 1 1 1 1 1 1 1 1 1 1 1 1 1 1 1 1
1 1 1 1 1 1 1 1 1 1 1 1 1 1 1 1 1 1 1 1 1 1 1 1 1 1 1
1 1 1 1 1 8 8 8 8 8 1 1 1 1 1 1 1 1 1 1 1 1 1 1 1 1 1
1 1 1 5 8 8 8 8 8 8 8 1 1 1 1 1 1 1 1 1 1 1 1 1 1 1 1
1 1 1 1 8 8 8 8 8 8 8 1 1 1 1 1 1 1 1 1 1 1 1 1 1 1 1
1 1 1 8 8 8 8 8 8 8 8 8 1 1 1 1 1 1 1 1 1 1 1 1 1 1 1
1 5 8 8 8 8 8 8 8 8 8 8 8 6 1 1 1 1 1 1 1 1 1 1 1 1 1
1 1 8 8 8 8 8 8 8 8 8 8 8 1 1 1 1 1 1 1 1 1 1 1 1 1 1
1 5 8 1 8 7 8 7 7 8 8 8 1 1 1 1 1 1 1 1 1 1 1 1 1 1 1
1 1 1 1 8 7 8 7 7 8 11 8 11 11 6 1 1 1 1 1 1 1 1 1 1 1 1
1 1 1 1 8 7 7 7 7 7 1 8 1 1 1 1 1 1 1 1 1 1 1 1 1 1 1
1 1 5 11 11 7 7 7 7 7 1 1 1 1 1 1 1 1 1 1 1 1 1 1 1 1 1
1 1 1 1 1 7 4 7 7 7 1 1 1 1 1 1 1 1 1 1 1 1 1 1 1 1 1
1 5 11 11 11 7 7 7 4 7 1 1 1 1 1 1 1 1 1 1 1 1 1 1 1 1 1
1 1 1 1 1 7 7 7 7 7 1 1 1 1 1 1 1 1 1 1 1 1 1 1 1 1 1
1 1 1 1 1 7 4 7 7 7 1 1 1 1 1 1 1 1 1 1 1 1 1 1 1 1 1
1 1 5 11 11 7 7 7 7 4 1 1 1 1 1 1 1 1 1 1 1 1 1 1 1 1 1
1 1 1 1 1 7 7 4 7 7 1 1 1 1 1 1 1 1 1 1 1 1 1 1 1 1 1
1 1 1 1 1 7 7 7 7 7 1 1 1 1 1 1 1 1 1 1 1 1 1 1 1 1 1
1 5 11 11 11 7 4 7 7 7 1 1 1 1 1 1 1 1 1 1 1 1 1 1 1 1 1
10 1 10 9 9 7 7 7 7 7 9 10 9 1 1 1 10 9 1 1 1 1 1 1 1 1 1
0 0 0 0 0 7 7 7 7 7 0 0 0 0 0 0 0 0 0 0 0 0 0 0 0 0 0
2 2 2 2 2 7 7 7 7 7 2 2 2 2 2 2 2 2 2 2 2 2 2 2 2 2 2
7 7 7 7 7 7 2 7 7 7 7 2 2 2 2 2 2 2 2 2 2 2 2 2 2 2 2
7 2 7 2 2 7 2 7 2 2 7 7 7 7 7 2 2 2 2 2 2 2 2 2 2 2 2