27 22
14 14 14 14 14 14 14 14 14 14 14 14 14 14 14 14 14 14 14 14 14 14 14 14 14 14 14
14 14 14 14 14 14 14 14 14 14 14 14 14 14 14 14 14 14 14 14 14 14 14 14 14 14 14
14 14 14 14 14 14 14 14 14 14 14 14 14 14 14 14 14 6 6 6 6 6 6 6 14 14 14
14 14 14 14 14 14 14 14 14 14 14 14 14 14 14 6 6 6 6 6 6 6 6 6 6 14 14
14 14 14 14 14 14 14 14 14 14 14 14 14 14 14 6 6 6 6 6 6 6 6 6 6 6 14
14 14 14 14 14 14 14 14 14 14 14 14 14 14 6 6 6 6 6 6 6 6 6 6 6 6 14
14 14 14 14 14 14 14 14 14 14 9 13 10 14 6 6 6 6 6 6 6 6 6 6 6 6 14
14 14 14 14 14 14 14 14 14 14 14 14 14 14 6 6 6 6 6 6 6 6 6 6 6 6 6
14 14 14 14 14 14 14 14 14 14 14 14 14 14 6 6 6 6 6 6 6 6 6 6 6 6 6
14 14 14 14 14 14 14 9 13 13 10 14 14 14 14 6 6 6 6 6 6 6 6 6 6 6 5
14 14 14 14 14 14 14 14 14 14 14 14 14 14 14 4 6 6 6 6 6 6 6 6 6 5 14
14 14 14 14 14 6 6 14 14 14 14 14 14 14 14 14 2 6 6 7 6 6 6 6 3 14 14
14 14 14 14 6 6 6 6 14 14 9 13 10 14 14 14 14 4 6 8 7 6 6 3 14 14 14
14 14 14 6 6 6 6 6 6 14 14 14 14 14 14 14 14 14 7 8 8 6 5 14 14 14 14
14 14 14 6 6 6 6 6 6 14 14 14 14 14 14 14 14 14 8 8 8 7 14 14 14 14 14
14 14 14 4 6 6 6 6 5 14 14 14 14 9 13 10 14 14 8 8 8 8 14 14 14 14 14
14 14 14 14 2 7 6 3 14 14 14 14 14 14 14 14 14 14 8 8 8 8 13 13 12 10 14
14 14 14 14 14 8 7 10 14 14 9 13 10 14 14 14 14 14 8 8 8 8 14 14 14 14 14
14 14 14 9 13 8 8 14 14 14 14 14 14 14 14 14 14 14 8 8 8 8 14 14 14 14 14
14 14 14 14 14 8 8 14 14 14 14 14 14 14 14 14 14 14 8 8 8 8 14 14 14 14 14
0 0 0 0 0 0 0 0 0 0 0 0 0 0 0 0 0 0 0 0 0 0 0 0 0 0 0
1 1 1 1 1 1 1 1 1 1 1 1 1 1 1 1 1 1 1 1 1 1 1 1 1 1 1