30 18
0 0 0 0 0 0 0 0 0 0 0 0 0 0 0 0 9 0 0 0 0 0 0 0 0 0 0 0 0 0
0 0 0 0 0 0 0 0 0 0 0 0 0 0 0 2 3 4 0 0 0 0 0 0 0 0 0 0 0 0
0 0 0 0 0 0 0 0 0 0 0 0 0 0 6 16 16 16 10 0 0 0 0 0 0 0 0 0 0 0
0 0 0 0 0 0 0 0 0 0 0 0 0 6 16 16 16 16 16 10 0 0 0 0 0 0 0 0 0 0
0 0 0 0 0 0 0 0 0 0 0 0 6 7 16 5 5 5 16 16 10 0 0 0 0 0 0 0 0 0
0 0 0 0 0 0 0 0 0 0 0 6 7 7 5 5 5 5 5 16 7 10 0 0 0 0 0 0 0 0
0 0 0 0 0 0 0 0 0 0 6 16 7 5 5 5 5 5 5 16 7 7 10 0 0 0 0 0 0 0
0 0 0 0 0 0 0 0 0 6 7 16 5 5 5 5 5 5 5 16 16 7 7 10 0 0 0 0 0 0
0 0 0 0 0 0 0 0 6 7 7 16 5 5 5 5 5 5 5 5 16 16 16 7 10 0 0 0 0 0
0 0 0 0 0 0 0 6 7 7 16 5 5 5 5 5 5 5 5 5 16 16 16 16 7 10 0 0 0 0
0 0 0 0 0 0 6 16 16 16 5 5 5 5 5 5 5 5 5 5 5 5 5 16 7 7 10 0 0 0
0 0 0 0 0 6 16 16 16 5 5 5 5 5 5 5 5 5 5 5 5 5 5 5 16 16 7 10 0 0
0 0 0 0 6 16 16 16 5 5 5 5 5 5 5 5 5 5 5 5 5 5 5 5 16 16 7 7 10 0
0 0 0 6 7 5 16 5 5 5 5 5 5 5 5 5 5 5 5 5 5 5 5 5 5 5 16 16 16 10
0 0 6 7 7 5 5 5 5 5 5 5 5 5 5 5 5 5 5 5 5 5 5 5 5 5 5 16 16 16
0 6 7 7 5 5 5 5 5 5 5 5 5 5 5 5 5 5 5 5 5 5 5 5 5 5 5 16 16 16
6 16 16 16 5 5 5 5 5 5 5 5 5 5 5 5 5 5 5 5 5 5 5 5 5 5 5 16 16 16
13 12 12 12 13 13 12 13 12 12 13 13 12 13 12 13 13 12 12 12 13 13 12 13 12 13 13 12 12 12