30 18
14 14 14 14 14 14 14 14 14 14 14 14 14 14 14 14 14 14 14 14 14 14 14 14 14 14 14 14 14 14
14 14 14 14 14 14 14 14 14 14 14 14 14 14 14 14 14 14 6 6 14 14 14 14 14 14 14 14 14 14
14 14 14 14 14 14 14 14 14 14 14 14 14 14 14 14 14 6 6 6 6 6 6 14 14 14 14 14 14 14
14 14 14 14 14 14 14 14 14 14 14 14 14 14 14 14 14 6 6 6 6 6 6 6 6 14 14 14 14 14
14 14 14 14 14 14 14 14 14 14 14 14 14 14 14 14 14 6 6 6 6 6 6 6 6 6 14 14 14 14
14 14 6 6 6 14 14 14 14 14 14 14 14 14 14 14 6 6 6 6 6 6 6 6 6 6 14 14 14 14
14 6 6 6 6 6 14 14 14 14 14 14 14 14 14 14 6 6 6 6 6 6 6 6 6 6 14 14 14 14
6 6 6 6 6 6 6 14 14 14 14 14 14 14 14 14 6 6 6 7 8 7 6 6 6 14 14 14 14 14
6 6 6 6 6 6 6 14 14 14 14 14 14 14 14 14 14 6 6 8 8 8 6 6 14 14 14 14 14 14
14 6 6 6 6 6 6 14 14 14 14 14 14 14 14 14 14 14 4 8 8 8 5 14 14 14 14 14 14 14
14 14 2 7 7 3 14 14 14 14 14 14 14 14 14 14 14 14 14 8 8 8 14 14 14 14 14 14 14 14
14 14 14 8 8 14 14 14 14 14 14 14 14 14 14 14 14 14 14 8 8 8 14 14 14 14 14 14 14 14
14 14 14 8 8 14 14 14 14 14 14 14 14 14 14 14 14 14 14 8 8 8 14 14 14 14 14 14 14 14
14 14 14 8 8 14 14 14 14 14 14 14 14 14 14 14 14 14 14 8 8 8 14 14 14 14 14 14 14 14
14 14 14 8 8 14 14 14 14 14 14 14 14 14 14 14 14 14 14 8 8 8 14 14 14 14 14 14 14 14
0 0 0 0 0 0 0 0 0 0 0 0 0 0 0 0 0 0 0 0 0 0 0 0 0 0 0 0 0 0
1 1 1 1 1 1 1 1 1 1 1 1 1 1 1 1 1 1 1 1 1 1 1 1 1 1 1 1 1 1
1 1 1 1 1 1 1 1 1 1 1 1 1 1 1 1 1 1 1 1 1 1 1 1 1 1 1 1 1 1