75 20
6 6 6 6 6 6 6 6 6 6 6 6 6 6 6 6 6 6 6 6 6 6 6 6 6 6 6 6 6 6 6 6 6 6 6 9 9 9 6 6 6 6 6 9 9 9 6 6 6 6 6 6 6 9 9 9 6 6 6 6 6 9 9 9 6 6 6 6 6 6 6 6 6 6 6
6 6 6 6 6 6 6 6 6 6 6 6 6 6 6 6 6 6 6 6 6 6 6 6 6 6 6 6 6 6 6 6 6 6 6 6 9 6 6 6 6 6 6 6 9 6 6 6 6 6 6 6 6 6 9 6 6 6 6 6 6 6 9 6 6 6 6 6 6 6 6 6 6 6 6
2 6 6 6 6 6 6 6 6 6 6 6 6 6 6 9 9 9 9 9 9 9 9 9 9 9 9 9 9 9 9 6 6 6 6 6 9 9 9 9 9 6 6 6 9 9 9 9 9 9 9 9 9 9 9 9 9 9 9 9 9 9 9 9 9 9 9 9 9 9 9 9 9 9 9
2 2 2 2 6 6 6 6 6 6 6 6 6 6 9 9 9 9 9 9 9 9 9 9 9 9 9 9 9 9 9 9 6 6 6 6 9 9 9 9 9 9 6 6 9 9 9 9 9 9 9 9 9 9 9 9 9 9 9 9 9 9 9 9 9 9 9 9 9 9 9 9 9 9 9
2 2 2 2 2 2 2 2 2 6 6 6 6 9 9 9 9 9 9 9 9 9 9 9 9 9 9 9 9 9 9 9 9 6 6 6 9 9 9 9 9 9 9 6 9 9 9 9 9 9 9 9 9 9 9 9 9 9 9 9 9 9 9 9 9 9 9 9 9 9 9 9 9 9 9
2 2 2 2 2 2 2 2 2 2 6 6 6 9 9 9 9 9 9 9 9 9 9 9 9 9 9 9 9 9 9 9 9 6 6 6 9 9 9 9 9 9 9 6 9 9 9 9 9 9 9 9 9 9 9 9 9 9 9 9 9 9 9 9 9 9 6 9 9 9 9 9 9 9 9
2 2 2 2 2 2 2 2 2 2 2 2 6 6 9 9 9 9 9 9 9 9 9 9 9 9 9 9 11 10 9 9 9 6 6 6 9 9 9 11 10 9 9 6 9 9 9 9 9 9 9 9 9 9 9 9 9 9 9 9 9 9 9 9 9 9 6 9 9 9 9 9 9 9 9
2 2 2 2 2 2 2 2 2 2 2 2 2 6 9 9 9 9 9 9 9 9 9 9 9 9 9 9 6 6 9 9 9 6 6 6 9 9 9 6 6 9 9 9 9 9 9 9 9 7 7 7 9 9 9 9 9 9 9 9 9 7 7 7 9 9 6 9 9 9 9 9 9 9 9
2 2 2 2 2 2 2 2 2 2 2 2 2 6 9 9 9 9 9 9 9 9 9 9 9 9 9 9 6 6 9 9 9 6 6 6 9 9 9 6 6 9 9 9 9 9 9 9 9 9 9 9 9 9 9 9 9 9 9 9 9 9 9 9 9 9 6 9 9 9 9 9 9 9 9
2 2 2 2 2 2 2 2 2 2 2 2 2 6 6 9 9 9 9 9 9 9 9 9 9 9 9 9 6 6 9 9 9 6 6 6 9 9 9 6 6 9 9 9 9 9 9 9 9 9 9 9 9 9 9 9 9 9 9 9 9 9 9 9 9 9 6 9 9 9 9 9 9 9 9
2 2 2 2 2 2 2 2 2 2 2 2 2 6 6 9 9 9 9 9 9 9 9 9 9 9 9 9 6 6 9 9 9 6 6 6 9 9 9 6 6 9 9 9 9 9 9 9 9 9 9 9 9 9 9 9 9 9 9 9 9 9 9 9 9 9 6 9 9 9 9 9 9 9 9
2 2 2 2 2 2 2 2 2 2 2 2 2 2 6 9 9 9 9 9 9 9 9 9 9 9 9 9 6 6 9 9 9 9 6 6 9 9 9 6 6 9 9 9 9 9 9 9 9 9 9 9 9 7 7 7 9 9 9 9 9 9 9 9 9 9 6 9 9 9 9 9 9 9 9
2 2 2 2 2 2 2 2 2 2 3 2 2 2 6 9 9 9 9 9 9 9 9 9 9 9 9 9 6 6 9 9 9 9 9 6 9 9 9 6 6 9 9 9 9 9 9 7 7 7 9 9 9 9 9 9 9 9 9 9 9 9 9 9 9 9 6 9 9 9 9 9 9 9 9
2 2 2 3 2 2 2 2 2 2 5 2 2 2 9 9 9 9 9 9 9 9 9 9 9 9 9 9 6 6 9 9 9 9 9 9 9 9 9 6 6 9 9 9 9 9 9 9 9 9 9 9 9 9 9 9 9 9 9 7 7 7 9 9 9 9 6 9 9 9 9 9 9 9 9
2 2 2 5 2 2 2 2 2 2 5 2 2 2 9 9 9 9 9 9 9 9 9 9 9 9 9 9 6 6 9 9 9 9 9 9 9 9 9 6 6 9 9 9 9 9 9 9 9 9 9 9 9 9 9 9 9 9 9 9 9 9 9 9 11 7 6 9 9 9 9 9 9 9 9
2 2 2 5 2 3 2 2 2 2 5 2 2 2 2 9 9 9 9 9 9 9 9 9 9 9 9 9 6 6 7 7 7 10 9 9 9 9 9 6 6 9 9 9 9 9 9 9 9 9 9 9 9 9 9 9 9 9 9 9 9 9 9 11 6 6 6 9 9 9 9 9 9 9 9
2 2 2 5 2 5 2 2 2 2 5 2 2 2 2 9 9 9 9 8 9 9 9 8 9 9 9 9 6 6 6 6 6 6 7 7 7 10 9 6 6 9 9 9 9 9 11 7 7 7 7 10 9 9 9 9 9 9 9 9 9 9 9 6 6 6 9 9 9 9 9 9 9 9 9
4 3 4 5 4 5 3 4 4 4 5 4 4 4 4 4 8 11 7 7 7 7 7 7 10 9 8 11 6 6 6 6 6 6 6 6 6 6 7 6 6 7 7 7 7 7 6 6 6 6 6 6 10 9 9 9 9 9 9 9 9 9 11 6 6 6 9 9 9 9 9 9 9 9 9
1 1 1 1 1 1 1 1 1 1 1 1 1 1 1 1 7 6 6 6 6 6 6 6 6 7 7 6 6 6 6 6 6 6 6 6 6 6 6 6 6 6 6 6 6 6 6 6 6 6 6 6 6 7 7 10 9 9 9 9 9 11 6 6 6 6 9 11 7 7 7 7 7 7 7
0 0 0 0 0 0 0 0 0 0 0 0 0 0 0 0 6 6 6 6 6 6 6 6 6 6 6 6 6 6 6 6 6 6 6 6 6 6 6 6 6 6 6 6 6 6 6 6 6 6 6 6 6 6 6 6 7 7 7 7 7 6 6 6 6 6 7 6 6 6 6 6 6 6 6