30 18
-1 -1 -1 -1 -1 -1 -1 -1 -1 -1 -1 -1 -1 -1 -1 -1 -1 -1 -1 -1 -1 -1 -1 -1 -1 -1 -1 -1 -1 -1
-1 -1 -1 -1 -1 -1 -1 -1 -1 -1 -1 -1 -1 -1 -1 -1 -1 -1 -1 -1 -1 -1 -1 -1 -1 -1 -1 -1 -1 -1
-1 -1 -1 -1 -1 -1 -1 -1 -1 -1 -1 -1 -1 -1 -1 -1 -1 -1 -1 -1 -1 -1 -1 -1 -1 -1 -1 -1 -1 -1
-1 -1 -1 -1 -1 -1 -1 -1 -1 -1 -1 -1 -1 -1 -1 -1 -1 -1 -1 -1 -1 -1 -1 -1 -1 -1 -1 -1 -1 -1
-1 -1 -1 -1 -1 -1 -1 -1 -1 -1 -1 -1 -1 -1 -1 -1 -1 -1 -1 -1 -1 -1 -1 -1 -1 -1 -1 -1 -1 -1
-1 -1 -1 -1 -1 -1 -1 -1 -1 -1 -1 -1 -1 -1 -1 -1 -1 -1 -1 -1 -1 -1 -1 -1 -1 -1 -1 -1 -1 -1
-1 -1 -1 -1 -1 -1 -1 -1 -1 -1 -1 -1 -1 -1 -1 -1 -1 -1 -1 -1 -1 -1 -1 -1 -1 -1 -1 -1 -1 -1
3 3 3 3 3 3 3 3 3 3 3 3 3 3 3 3 3 3 3 3 3 3 3 3 3 3 3 3 3 3
1 1 1 0 -1 -1 -1 -1 -1 -1 -1 -1 -1 1 1 1 -1 -1 -1 -1 -1 -1 -1 -1 -1 -1 1 1 1 1
1 1 1 0 -1 -1 -1 -1 -1 2 3 4 -1 1 1 1 2 3 3 3 3 4 -1 -1 -1 -1 1 1 1 1
1 1 1 0 2 3 3 4 -1 -1 5 5 -1 1 1 1 5 5 -1 5 -1 -1 -1 -1 -1 -1 1 1 1 1
0 1 1 0 -1 5 5 -1 -1 -1 5 -1 -1 1 1 1 5 5 -1 5 -1 -1 -1 -1 -1 -1 0 1 1 1
0 1 1 0 -1 5 -1 -1 -1 -1 5 -1 -1 1 0 1 5 -1 -1 2 3 3 4 -1 -1 -1 0 1 1 0
0 1 0 0 -1 -1 2 3 3 3 3 4 -1 1 0 0 5 -1 -1 -1 5 -1 5 -1 -1 -1 0 1 1 0
0 0 0 0 -1 -1 -1 -1 5 5 5 -1 -1 1 0 0 -1 -1 -1 -1 5 -1 5 -1 -1 -1 0 1 0 0
0 0 0 0 -1 -1 -1 -1 5 -1 5 -1 -1 1 0 0 2 3 4 -1 5 -1 -1 -1 -1 -1 0 1 0 0
0 0 0 0 -1 2 3 3 4 -1 5 -1 -1 0 0 0 -1 5 5 -1 -1 2 3 3 4 -1 0 1 0 0
0 0 0 0 -1 5 5 5 -1 -1 -1 -1 -1 0 0 0 -1 -1 5 -1 -1 5 5 5 5 -1 0 0 0 0