30 65
-1 -1 -1 -1 -1 -1 -1 -1 -1 -1 -1 -1 -1 -1 -1 -1 -1 -1 -1 -1 -1 -1 -1 -1 -1 -1 -1 -1 -1 -1
-1 -1 -1 -1 -1 -1 -1 -1 -1 -1 -1 -1 -1 -1 -1 -1 -1 -1 -1 -1 -1 -1 -1 -1 -1 -1 -1 -1 -1 -1
-1 -1 -1 -1 -1 -1 -1 -1 -1 -1 -1 -1 -1 -1 -1 -1 -1 -1 -1 -1 -1 -1 -1 -1 -1 -1 -1 -1 -1 -1
3 3 3 3 3 3 3 3 3 3 3 3 3 3 3 3 3 3 3 3 3 3 3 3 3 3 3 3 3 3
1 1 1 1 -1 -1 -1 -1 -1 -1 -1 -1 1 1 1 1 1 -1 -1 -1 -1 -1 -1 -1 -1 0 1 1 0 1
1 1 1 1 -1 -1 -1 2 3 3 3 3 1 1 1 1 1 -1 -1 -1 -1 -1 -1 -1 -1 0 1 1 0 1
1 0 1 1 -1 -1 -1 -1 5 5 -1 5 1 1 1 1 1 -1 -1 -1 -1 -1 -1 -1 -1 -1 1 1 0 1
1 0 1 1 3 3 4 -1 -1 5 -1 5 1 1 1 1 1 3 3 3 4 -1 -1 -1 -1 -1 0 1 0 1
0 0 1 1 0 5 2 3 3 4 -1 -1 1 1 1 0 1 5 5 5 -1 -1 -1 -1 -1 -1 0 1 0 1
0 0 0 1 0 5 5 5 -1 5 -1 -1 1 1 1 0 1 5 5 -1 -1 -1 -1 -1 -1 -1 1 1 0 1
1 0 0 1 0 5 5 5 -1 -1 -1 -1 1 1 1 0 1 5 5 2 3 3 3 3 4 -1 1 0 0 1
1 0 0 0 0 5 -1 5 -1 -1 -1 -1 1 1 0 0 1 -1 5 5 5 -1 5 -1 5 -1 1 0 0 1
1 0 1 0 -1 5 -1 5 2 3 3 3 0 1 0 0 1 -1 -1 5 -1 -1 5 -1 5 -1 1 1 0 1
1 0 1 0 -1 -1 -1 -1 5 -1 5 -1 0 0 0 0 1 3 4 5 -1 -1 5 -1 -1 -1 1 1 0 1
1 0 1 0 -1 -1 -1 -1 5 -1 5 -1 0 0 0 1 0 -1 5 -1 -1 -1 5 -1 -1 -1 1 1 0 0
1 0 1 0 2 3 3 3 3 4 -1 -1 0 1 0 1 0 -1 5 -1 -1 2 3 3 3 3 0 1 0 0
1 0 1 0 5 5 5 5 -1 5 3 3 0 1 0 1 0 -1 5 -1 -1 -1 5 -1 5 5 0 1 0 0
1 0 1 0 5 5 5 5 -1 5 0 1 0 1 0 1 0 1 -1 -1 -1 -1 5 -1 -1 5 0 1 0 0
0 0 1 0 -1 5 -1 -1 -1 5 0 1 0 1 0 0 0 1 -1 2 3 4 5 -1 -1 5 0 1 1 0
0 0 1 0 -1 5 2 3 4 5 0 1 0 1 0 0 0 1 -1 5 5 5 -1 -1 -1 5 0 1 1 0
0 1 1 0 -1 5 -1 5 5 5 0 1 1 1 0 0 1 1 -1 5 -1 5 -1 -1 -1 5 0 1 1 0
0 1 1 0 -1 -1 -1 -1 5 5 0 1 1 1 1 0 1 1 -1 5 -1 5 -1 -1 -1 -1 0 1 1 0
0 1 0 0 3 3 3 4 -1 5 0 0 1 0 1 0 1 1 -1 -1 -1 5 -1 -1 -1 -1 0 0 1 0
0 1 0 0 5 -1 5 -1 -1 -1 0 0 1 0 1 0 1 0 3 3 3 3 3 3 3 3 0 0 1 0
0 1 0 0 5 -1 -1 -1 -1 -1 -1 -1 1 0 1 1 1 0 0 0 0 0 0 0 0 1 0 0 1 0
1 1 0 1 5 2 3 3 3 3 4 -1 1 0 1 1 0 -1 -1 -1 -1 -1 -1 -1 -1 1 0 0 1 0
1 1 1 1 5 -1 5 -1 5 -1 -1 -1 0 0 0 1 0 -1 -1 -1 -1 -1 -1 -1 -1 1 0 0 0 0
1 1 1 1 5 -1 5 -1 5 -1 -1 -1 -1 -1 -1 -1 -1 -1 -1 -1 -1 -1 -1 -1 -1 1 0 1 0 0
1 0 1 1 -1 -1 5 -1 2 3 4 -1 -1 -1 -1 -1 -1 -1 -1 -1 -1 -1 -1 -1 -1 1 1 1 0 0
1 0 0 1 3 3 4 -1 -1 5 -1 -1 0 1 0 0 0 -1 -1 -1 2 4 -1 -1 -1 -1 1 1 0 0
1 0 0 0 5 5 5 -1 -1 5 -1 -1 0 1 1 0 1 -1 -1 -1 -1 5 -1 -1 -1 -1 1 1 0 1
1 0 1 0 5 -1 5 -1 -1 5 -1 -1 0 1 1 0 1 3 3 4 -1 5 -1 -1 -1 -1 1 1 0 1
1 0 1 0 5 -1 5 -1 -1 -1 -1 -1 0 1 1 0 1 5 -1 5 -1 5 -1 -1 -1 -1 1 0 0 1
1 0 1 0 5 -1 2 3 3 3 4 -1 1 1 1 0 1 5 -1 5 -1 -1 2 3 3 3 0 1 0 1
1 0 1 0 5 -1 5 -1 5 -1 5 -1 1 1 1 0 1 5 -1 5 -1 -1 5 -1 5 5 0 1 1 1
1 0 1 0 -1 -1 5 -1 -1 -1 5 -1 1 1 0 0 1 5 -1 5 -1 -1 -1 -1 5 5 1 1 1 0
0 0 0 0 -1 2 3 3 4 -1 5 -1 1 0 0 0 1 5 -1 -1 -1 -1 -1 -1 -1 5 1 1 1 0
0 1 1 0 -1 5 -1 5 5 -1 5 -1 1 0 1 0 0 5 2 3 3 3 4 -1 -1 5 0 1 0 0
0 1 1 0 -1 5 -1 5 -1 -1 -1 -1 1 0 1 1 0 -1 5 -1 5 -1 5 -1 -1 5 0 1 1 1
0 1 1 0 -1 5 -1 -1 2 3 3 3 1 1 1 1 0 -1 5 -1 5 -1 5 -1 -1 5 0 1 1 1
1 1 1 0 -1 5 -1 -1 5 -1 5 -1 1 0 1 1 0 -1 5 -1 -1 -1 -1 -1 -1 5 1 1 1 1
1 1 1 0 -1 -1 -1 -1 -1 -1 5 -1 1 0 0 1 0 -1 5 -1 2 3 3 3 4 -1 1 1 1 1
1 1 1 0 -1 -1 2 3 3 4 5 -1 1 0 0 1 1 -1 5 -1 5 -1 5 -1 5 -1 1 1 0 1
1 1 1 0 -1 -1 5 -1 5 -1 -1 3 0 0 0 1 1 -1 -1 -1 5 -1 5 -1 -1 -1 1 1 0 1
1 0 1 0 -1 -1 5 -1 -1 -1 -1 1 0 0 0 1 1 -1 -1 -1 5 -1 5 -1 -1 -1 1 1 0 0
1 0 1 0 3 3 3 3 3 3 3 1 0 1 1 1 1 3 3 4 5 -1 5 -1 -1 -1 1 1 1 0
1 0 1 1 0 0 0 0 0 0 0 0 0 1 1 1 1 5 -1 5 5 -1 -1 -1 -1 -1 1 0 1 0
1 0 1 1 -1 -1 -1 -1 -1 -1 -1 -1 -1 -1 -1 -1 -1 5 -1 -1 5 2 3 3 4 -1 1 0 1 1
1 0 1 1 -1 -1 -1 -1 -1 -1 -1 -1 -1 -1 -1 -1 -1 5 -1 -1 -1 5 -1 -1 5 -1 1 0 1 1
1 0 1 1 -1 -1 -1 -1 -1 -1 -1 1 1 1 1 1 0 5 -1 -1 -1 5 -1 -1 5 -1 0 0 1 1
1 0 1 1 3 -1 -1 -1 -1 -1 -1 1 1 1 1 1 0 5 -1 -1 -1 -1 -1 -1 5 -1 0 0 1 1
1 0 1 1 0 -1 -1 2 3 3 3 1 1 1 1 1 0 2 3 3 3 3 4 -1 5 -1 0 1 0 1
1 0 1 1 5 -1 -1 5 5 5 -1 0 1 1 1 1 1 -1 5 -1 5 -1 5 -1 5 -1 0 1 0 1
1 0 0 1 5 -1 -1 5 -1 5 -1 5 1 1 1 1 1 -1 5 -1 5 -1 -1 -1 -1 1 0 1 0 1
1 0 0 1 5 -1 -1 5 2 3 4 5 1 0 1 1 1 -1 5 -1 -1 2 3 3 3 1 0 1 0 1
0 0 0 1 5 -1 -1 -1 -1 5 5 5 1 0 1 1 1 -1 5 -1 -1 5 5 -1 5 -1 0 1 0 1
0 0 0 1 2 3 3 4 -1 5 -1 5 1 0 1 0 1 -1 5 -1 -1 5 5 -1 5 -1 0 1 0 1
0 0 0 1 5 5 5 5 -1 5 -1 -1 1 0 1 0 1 -1 -1 -1 -1 5 2 4 5 -1 0 1 0 1
0 0 0 1 -1 5 5 -1 2 3 3 4 1 0 0 0 1 3 3 4 -1 5 5 -1 5 -1 0 1 0 1
0 0 0 1 -1 5 -1 -1 5 5 5 5 1 0 0 0 1 5 -1 5 -1 5 5 -1 -1 -1 0 1 0 1
0 0 0 1 -1 2 3 4 -1 5 5 -1 1 0 1 0 0 5 -1 5 -1 -1 5 -1 -1 -1 0 0 0 1
0 0 0 1 -1 5 5 5 -1 -1 5 -1 1 0 1 0 0 5 -1 -1 2 3 3 4 -1 -1 0 0 0 1
0 0 0 0 -1 -1 5 5 2 3 4 -1 1 0 1 0 0 5 -1 -1 -1 5 -1 5 -1 -1 0 0 0 1
0 0 0 0 -1 -1 -1 5 -1 -1 5 -1 1 1 0 0 0 -1 -1 -1 -1 5 -1 -1 -1 -1 0 0 0 1
0 0 0 0 -1 2 3 3 3 3 4 -1 0 1 0 0 0 -1 2 3 3 3 3 3 4 -1 0 0 0 0