20 16
1 1 1 1 1 1 1 1 1 1 1 1 1 1 1 1 1 1 1 1
1 3 1 1 1 1 1 1 1 1 1 1 1 1 1 1 1 1 1 1
1 1 1 1 1 1 1 1 1 1 1 1 1 1 1 1 1 1 1 1
1 1 1 1 1 1 1 1 1 1 1 1 1 1 1 1 1 1 1 1
1 1 1 1 1 1 1 1 1 1 1 1 1 1 1 1 1 1 1 1
1 1 1 1 1 1 1 1 1 1 1 1 1 1 1 1 1 1 1 1
1 1 1 1 1 1 1 1 1 1 1 1 1 1 1 1 1 1 1 1
1 1 1 1 1 1 1 1 1 1 1 1 1 1 1 1 1 1 1 1
1 1 1 1 1 1 1 1 1 1 1 1 1 1 1 1 1 1 1 1
1 1 1 1 1 1 1 1 1 1 10 1 1 1 1 9 1 1 1 1
14 14 14 0 0 0 0 0 0 0 0 0 0 0 0 0 0 0 0 0
15 15 15 2 2 2 2 2 2 2 2 2 2 2 2 2 2 2 2 2
15 15 15 2 2 2 2 2 2 2 2 2 2 2 2 2 2 2 2 2
16 16 16 2 2 2 2 2 2 2 2 2 2 2 2 2 2 2 2 2
16 16 16 2 2 2 2 2 2 2 2 2 2 2 2 2 2 2 2 2
16 16 16 16 16 16 16 16 16 16 16 16 2 2 2 2 2 2 2 2